#SETTING::shuffle->false
#SETTING::doGaps->false
#SETTING::infinite->false
#SETTING::autoCoinSpawn->false

#ALIAS::1->edu.kit.informatik.ragnarok.logic.gameelements.inanimate.Inanimate
#ALIAS::10->edu.kit.informatik.ragnarok.logic.gameelements.entities.pickups.Coin
#ALIAS::81->edu.kit.informatik.ragnarok.logic.gameelements.inanimate.MovingBox
#ALIAS::86->edu.kit.informatik.ragnarok.logic.gameelements.inanimate.ClimbUpBox


{
{0	0	0	10	10	10	0	0	0}
{0	0	0	0	0	0	0	0	0}
{0	0	0	0	0	0	0	0	0}
{0	0	0	0	0	0	0	0	0}
{0	0	0	0	0	0	0	0	0}
{0	0	0	81:2	81:2	81:2	0	0	0}
{0	0	0	0	0	0	0	0	0}
{0	0	0	0	0	0	0	0	0}
{1	1	1	1	1	1	1	1	1}
}
{ 
{0	0	1	0	10	10	1	0	0}
{0	0	1	0	0	0	1	0	0}
{0	0	1	0	81:1:1	81:1:1	1	0	0}
{0	0	1	0	0	0	1	0	0}
{0	0	1	0	0	0	1	0	0}
{0	0	1	0	0	0	1	0	0}
{0	0	1	81:1	81:1	0	1	0	0}
{0	0	0	0	0	0	0	0	0}
{1	1	1	1	1	1	1	1	1}
}
{
{0	0	0	0	0	0	1	10	10}
{0	0	0	0	0	0	1	10	10}
{0	0	0	0	0	0	1	10	10}
{0	0	0	0	86	86	86	86	86}
{0	0	0	0	0	0	0	0	0}
{0	0	0	0	0	0	0	0	1}
{0	0	0	0	1	0	0	0	1}
{0	0	0	1	1	0	0	0	1}
{1	1	1	1	1	1	1	0	1}
}
{
{0	0	0	0	0	0	0	0	0}
{0	0	0	0	0	0	0	0	0}
{0	0	0	0	0	0	0	0	0}
{86	0	0	0	0	0	0	0	0}
{0	0	0	0	0	0	0	0	0}
{0	0	0	0	0	0	0	0	0}
{0	0	0	0	0	0	0	0	0}
{0	0	0	0	0	0	0	0	0}
{1	1	1	1	1	1	1	1	1}
}
{
{0	0	0	0	0	0	0	0	0}
{0	0	0	0	0	0	0	10	10}
{0	0	0	0	0	0	0	0	0}
{0	0	0	86	86	0	0	1	1}
{0	0	0	0	0	0	0	0	0}
{86	86	0	0	0	0	0	0	0}
{0	0	0	0	0	0	0	0	0}
{0	0	0	0	0	0	0	0	0}
{1	1	0	0	0	0	0	0	0}
}
{
{0	0	0	0	0	0	0	0	0}
{0	0	0	0	0	0	0	86	86}
{0	0	0	0	0	0	0	0	0}
{0	0	0	0	0	0	0	0	0}
{0	0	0	0	0	0	0	0	0}
{0	0	0	81	81	0	0	0	0}
{0	0	0	0	0	0	0	0	0}
{0	0	0	0	0	0	0	0	0}
{0	0	0	0	0	0	0	0	0}
}
{
{0	0	0	0	0	0	0	0	0}
{0	0	0	0	0	0	0	0	0}
{0	0	0	0	0	0	0	0	0}
{0	0	0	0	0	0	0	0	0}
{0	0	0	0	0	0	0	0	0}
{0	0	81:2:1	81:2:1	0	0	0	0	0}
{0	0	0	0	0	0	0	0	0}
{0	0	0	0	0	0	0	0	0}
{0	0	0	0	0	0	1	1	1}
}
{
{0	0	0	0	0	0	0	0	0}
{0	0	0	1	86:1	86:1	86:1	86:1	86:1}
{0	0	0	1	0	0	0	0	0}
{0	0	0	1	0	0	0	0	0}
{0	0	86	86	0	0	0	0	0}
{86	86	0	0	0	0	0	0	0}
{0	0	0	0	0	0	0	0	0}
{0	0	0	0	0	0	0	0	0}
{0	0	0	0	0	0	0	0	0}
}