#SETTING::shuffle->false
#SETTING::doGaps->false
#SETTING::infinite->false
#SETTING::autoCoinSpawn->false

#ALIAS::1->Inanimate
#ALIAS::10->Coin
#ALIAS::80->ToggleBox
#ALIAS::85->BoostBox
#ALIAS::86->ClimbUpBox

{ 
{0	0	0	0	0	0	0	0	0}
{0	0	0	0	0	0	0	0	0}
{0	0	0	0	0	0	0	0	0}
{0	0	0	10	10	0	0	0	0}
{0	0	0	0	0	0	0	0	0}
{0	0	0	0	0	0	0	0	0}
{0	0	0	80	80	0	0	0	0}
{0	0	0	0	0	0	0	0	0}
{1	1	1	1	1	1	1	1	1}
}
{ 
{0	0	0	0	0	0	0	0	0}
{0	0	0	0	0	10	10	0	0}
{0	0	0	0	0	0	0	0	0}
{0	0	10	10	0	0	0	0	0}
{0	0	0	0	0	85	85	0	0}
{0	0	0	0	0	0	0	0	0}
{0	0	80	80	0	0	0	0	0}
{0	0	0	0	0	0	0	0	0}
{1	1	1	1	1	0	0	1	1}
}
{ 
{0	0	0	0	0	0	0	0	0}
{0	0	0	0	0	0	0	0	0}
{0	0	0	0	0	0	0	0	0}
{0	0	0	0	0	0	0	0	0}
{0	0	0	0	0	0	0	0	0}
{0	0	0	86	86	86	0	0	0}
{0	0	0	0	0	0	0	0	0}
{0	0	0	0	0	0	0	0	0}
{1	1	0	0	0	0	0	1	1}
}
{ 
{0	0	0	0	0	0	0	0	0}
{0	0	0	0	0	0	0	0	0}
{0	0	0	10	10	0	0	0	0}
{0	0	0	10	10	0	0	0	0}
{0	0	0	10	10	0	0	0	0}
{0	0	86	85	85	0	0	0	0}
{0	0	0	0	0	0	0	0	0}
{0	0	0	0	0	0	0	0	0}
{0	0	0	0	1	1	1	1	1}
}
{ 
{0	0	0	0	0	0	0	0	0}
{0	0	0	0	0	0	0	0	0}
{0	0	0	0	0	0	0	0	0}
{0	0	0	0	0	0	0	0	0}
{0	0	0	0	0	0	0	0	0}
{0	0	0	86	0	86	0	0	0}
{0	0	0	0	0	0	0	0	0}
{0	0	0	0	0	0	0	0	0}
{85	85	0	0	85	0	0	85	85}
}
{ 
{0	0	0	0	0	0	0	0	0}
{0	0	0	0	0	0	0	0	0}
{0	0	0	0	0	0	0	0	0}
{0	0	0	0	0	0	0	0	0}
{0	0	0	0	0	0	0	0	0}
{0	0	0	0	0	0	0	0	0}
{0	0	0	0	0	0	0	0	0}
{0	0	0	0	0	0	0	0	0}
{1	85	0	0	0	0	0	0	0}
}