#SETTING::name->Introducting_Gravitational_Engines
#SETTING::shuffle->false
#SETTING::doGaps->false
#SETTING::infinite->false
#SETTING::autoCoinSpawn->false

#ALIAS::1->Inanimate
#ALIAS::2->RektKiller
#ALIAS::10->DefaultCoin
#ALIAS::11->SuperCoin
#ALIAS::12->EvilCoin
#ALIAS::80->ToggleBox
#ALIAS::81->MovingBox
#ALIAS::86->ClimbUpBox


{
{0	0	0	10	10	10	0	0	0}
{0	0	0	0	0	0	0	0	0}
{0	0	0	0	0	0	0	0	0}
{0	0	0	0	0	0	0	0	0}
{0	0	0	0	0	0	0	0	0}
{0	0	0	81:2	81:2	81:2	0	0	0}
{0	0	0	0	0	0	0	0	0}
{0	0	0	0	0	0	0	0	0}
{1	1	1	1	1	1	1	1	1}
}
{
{0	0	1	0	10	10	1	0	0}
{0	0	1	0	0	0	1	0	0}
{0	0	1	0	81:1:1	81:1:1	1	0	0}
{0	0	1	0	0	0	1	0	0}
{0	0	1	0	0	0	1	0	0}
{0	0	1	0	0	0	1	0	0}
{0	0	1	81:1	81:1	0	1	0	0}
{0	0	0	0	0	0	0	0	0}
{1	1	1	1	1	1	1	1	1}
}
{
{0	0	0	0	1	1	1	10	10}
{0	0	0	0	1	10	1	10	10}
{0	0	0	0	1	1	1	10	10}
{0	0	0	0	86	86	86	86	86}
{0	0	0	0	0	0	0	0	0}
{0	0	0	0	0	0	0	0	1}
{0	0	0	0	1	0	0	0	1}
{0	0	0	1	1	0	0	0	1}
{1	1	1	1	1	1	1	0	1}
}
{
{0	0	0	0	0	0	0	0	0}
{0	0	0	0	0	0	0	0	0}
{0	0	0	0	0	0	0	0	0}
{0	0	0	0	0	0	0	0	0}
{0	0	0	0	0	0	0	0	0}
{0	0	0	0	0	0	0	0	0}
{0	0	0	0	0	0	0	0	0}
{0	0	0	0	0	0	0	0	0}
{1	1	1	1	1	1	1	1	1}
}
{
{1	1	0	1	1	0	0	0	0}
{1	1	0	1	1	0	0	10	10}
{1	1	0	1	1	0	0	0	0}
{1	1	0	86	86	0	0	1	1}
{1	1	0	0	0	0	0	1	1}
{86	86	0	0	0	0	0	1	1}
{0	0	0	0	0	0	0	1	1}
{0	0	0	0	0	0	0	1	1}
{1	1	0	0	0	0	0	1	1}
}
{
{0	0	0	0	0	0	1	1	1}
{0	0	0	0	0	0	86	86	86}
{0	0	0	0	0	0	0	0	0}
{0	0	0	0	0	0	0	0	0}
{0	0	0	0	0	0	0	0	0}
{0	0	0	81	81	0	0	0	0}
{0	0	0	0	0	0	0	0	0}
{0	0	0	0	0	0	0	0	0}
{0	0	0	0	0	0	0	0	0}
}
{
{1	0	0	0	0	0	0	0	0}
{0	0	0	0	0	0	0	0	0}
{0	0	0	0	0	0	0	0	0}
{0	0	0	0	0	0	0	0	0}
{0	0	0	0	0	0	0	0	0}
{0	0	81:2:1	81:2:1	0	0	0	0	0}
{0	0	0	0	0	0	0	0	0}
{0	0	0	0	0	0	0	0	0}
{0	0	0	0	0	0	1	1	1}
}
{
{1	1	1	1	10	10	10	10	10}
{1	1	1	1	86	86	86	86	86}
{1	1	1	1	0	0	0	0	0}
{1	1	1	1	0	0	0	0	0}
{1	1	86:3000	86:3000	0	0	1	0	0}
{86	86	0	0	0	0	0	0	0}
{0	0	0	0	0	0	0	0	0}
{0	0	0	0	0	0	0	0	0}
{0	0	0	0	0	0	0	0	0}
}
{
{0	0	0	0	0	0	0	0	0}
{0	0	0	0	0	0	0	0	0}
{0	0	0	0	0	0	0	0	0}
{0	0	0	0	0	0	0	0	0}
{0	0	0	0	0	0	0	0	0}
{0	0	0	0	0	0	0	0	0}
{0	0	0	0	0	0	0	0	0}
{0	0	0	0	0	0	0	0	0}
{0	0	0	0	0	0	1	1	1}
}
{
{0	1	1	0	0	1	1	0	0}
{0	1	1	0	0	1	1	0	0}
{0	1	1	0	0	1	1	0	0}
{0	1	1	0	0	1	1	0	0}
{0	1	1	0	2:0:15	1	1	0	0}
{0	1	1	2:0:15	0	1	1	0	0}
{0	86	86	0	0	86	86	0	0}
{0	0	0	0	0	0	0	0	0}
{1	1	1	1	1	1	1	1	1}
}
{
{1	1	1	1	1	1	1	1	86:2000	86:2000	86:1000	86:1000	86	86}
{1	1	1	1	1	1	86:3000	86:3000	0	00	0	0	0	0}
{86	86	86	86	86	86	0	0	0	00	0	0	0	0}
{0	0	0	0	0	0	0	0	12	12	12	12	0	0}
{0	0	2:2:15	2:2:15	0	0	0	0	12	12	12	12	0	0}
{1	1	0	0	1	1	0	0	0	00	0	0	0	0}
{1	1	0	0	1	1	0	0	0	00	0	0	0	0}
{1	1	0	0	1	1	0	0	0	00	0	0	0	0}
{1	1	0	0	1	1	0	0	0	00	0	0	1	1}
}

{
{1	0	0	0	0	0	2:2:15	0	0	1}
{1	0	0	0	0	0	0	0	0	1}
{1	10	10	0	0	0	0	10	10	1}
{1	10	10	0	0	0	0	10	10	1}
{1	0	0	2:2:15	0	0	0	0	0	1}
{86	86	86	86	0	0	86:2000	86:2000	86:2000	86:2000}
{0	0	0	0	0	0	0	0	0	0}
{0	0	0	0	0	0	0	0	0	0}
{0	0	0	0	80	80	0	0	0	0}
}


{
{0	0	1	1}
{0	0	1	1}
{0	0	1	1}
{0	0	86	86}
{0	0	0	0}
{0	0	0	0}
{0	0	1	1}
{0	0	1	1}
{0	0	1	1}
}
{
{0	0	0	0	0	0}
{0	0	0	0	0	0}
{0	0	0	0	0	0}
{0	0	0	0	0	0}
{0	0	0	0	0	0}
{0	0	0	0	0	0}
{0	0	0	0	0	0}
{0	0	0	0	0	0}
{0	0	0	0	0	0}
}
